17 37
#####################################
#>..................................#
#...###....###.........######..##...#
#...###.......#########.............#
#........###....#........#..........#
#...##...#.............###....###...#
#........#...#########...#....###...#
#........#...#.......#...#..........#
#............#.......#........###...#
#.......#....#########.....#....#...#
#..###..#.............  ####....#...#
#....#......##.............#........#
###..#...#.....##########....##..#..#
#........#.........#.............#..#
#...########.......#.....#######....#
#...................................#
#####################################
